id	spanish	english	catalan
spanish	Castellano	Spanish	Castellà
english	Inglés	English	Anglés
catala	Catalan	Catalan	Català
continue	Continuar	Continue	Continuar
newGame	Nueva Partida	New Game	Nova Partida
loadGame	Cargar Partida	Load Game	Carregar Partida
options	Opciones	Options	Opcions
exit	Salir	Exit	Sortir
general	General	General	General
graphics	Gráficos	Graphics	Gràfics
sound	Sonido	Sounds	Só
controls	Controles	Controls	Controls
pause	Pausa	Pause	Pausa
defaultSettings	Restablecer configuración	Reset Settings	Restablir configuració
saveSettings	Guardar Configuración	Save Settings	Desa configuració
back	Volver	Back	Tornar
language	Lenguaje	Language	Llenguatge
extraInformation	Información extra	Extra Information	Informació adicional
hudSize	Tamaño del HUD	HUD Size	Mida del HUD
resolution	Resolución	Resolution	Resolució
fullScreen	Pantalla completa	FullScreen	Pantalla completa
quality	Calidad	Quality	Qualitat
vSync	VSync	VSync	VSync
textureQyality	Calidad de texturas	Texture Quality	Qualitat de textures
antiAlising	Anti-Alising	Anti-Alising	Anti-Alising
shadows	Sombras	Shadows	Ombres
gamma	Gama	Gamma	Gamma
masterSound	Volumen Maestro	Master Volume	Volum mestre
fxSound	Volúmen de FX	FX Valume	Volums de FX
musicSound	Volúmen de música	Music Volume	Volum de música
fast	Rápido	Fast	Ràpid
good	Bueno	Good	Bó
fantastic	Fantástico	Fantastic	Fantàstic
ultra	Ultra	Ultra	Ultra
low	Baja	Low	Baix
medium	Medio	Medium	Mitjà
high	Alto	High	Alt
hold	Mantener	Hold	Mantenir
press	Presionar	Press	Pressionar
open	Abrir	Open	Obrir
disabled	Desactivado	Disabled	Desactivat
close	Cerrar	Close	Tanca
buildings	Edificios	Buildings	Edificis
townHall	Ayuntamiento	Town Hall	Ajuntament
house	Casa	House	Casa
goldenMine	Mina	Golden Mine	Mina
farm	Granja	Farm	Granja
lumberMill	Aserradero	Lumber Mill	Aserreria
warehouse	Almacen	Warehouse	Magatzem
bridge	Puente	Bridge	Pont
barracks	Cuartel	Barracks	Barraques
castle	Castillo	Castle	Castell
church	Iglesia	Church	Església
fireStation	Estación de bomberos	Fire Station	Estació de bombers
gold	Oro: 	Gold: 	Or: 
foot	Comida: 	Foot: 	Menjar: 
wood	Madera: 	Wood: 	Fusta: 
population	Población: 	Population: 	Població: 
houseInfo	Casa: Sirve para aumentar la población.	House: Allows you yo have more people.	Casa: Serveix per aumentar la població.
townHallInfo	Ayuntamiento: Permite construir más edificios.	Town Hall: Allows you yo build other buildings	Ayuntament: Permet construir més edificis.
goldenMineInfo	Mina: Produce oro.	GoldMine: Produces gold.	Mina: Produeix or.
farmInfo	Granja: Produce alimento.	Farm: Produces food.	Granja: Produeix aliment.
lumberMillInfo	Aserradero: Produce madera.	LumberMill: Produces wood.	Aserrader: Produeix fusta.
barracksInfo	Barracones: Aumentan el daño de tus torres.	Barracks: Increases towers's damage output.	Barracons: Millora la força de les torres.
castleInfo	Castillo: Ganas la partida	Castle: You win the game.	Castell: Guanyes la partida.
churchInfo	Iglesia: Aumenta la felicidad.	Church: Max happines upgraded.	Esglesia: Aumenta la felicitat máxima.
fireStationInfo	Estación de bomberos: Apagan fuegos.	FireStation: Puts out the fire of buildings.	Estació de bombers: Apaguen focs.
warehouseInfo	Almacen: Aumenta la capacidad maxima de los recursos	Warehouse: Allows to storage more resources	Magatzem: Permet emagatzemar més recursos
towerInfo	Torre: Dispara a las unidades enemigas.	Tower: Shoots enemy units.	Torre: Dispara unitats enemiges.
skipTutorial	Omitir Tutorial	Skip Tutorial	Saltar Tutorial